###############
#        O    #
# P      ######
#             #
########      #
# O  ##O#     #
#    ##       #
#             #
# X           #
#             #
#             #
#             #
#             #
#  X          #
#             #
#             #
#           X #
#           # #
###############
